....................
.##################.
.#................#.
.#................#.
.##################.
....................