..........
...###....
..........
..~~~.....
..........